5
1,1,1,0,1
2,2,1,0,0
3,2,2,0,1
4,3,3,0,1
5,1,3,0,0
